######
#S...#
#...##
#...E#
######