###.#.....
###.#.###.
#.....#...
..##..#.##
#...###..S
###...#..#
..#.#..###
#...##.#.#
###..#...#
#######E##