S.##..##.#
#.#....#.#
#...##....
######.#.#
##...#.#.#
...#.#...#
#E##.##.##
##........
#.##.##.#.
#....##.##